11111111111111111111
100000000000C0000001
10000C00000000000111
1E00000000000000C011
1111000C001100000011
11C000000C1100010001
11111111111100000001
1CC11110000000110011
10011110000000000011
10011000CCC011000001
10011110000011000001
10011111111100000001
10C11000000000000011
10000000000000011111
100000000C0001111CC1
10011110000111000001
10011000000111000001
100000000C0111000001
100C00000000000000P1
11111111111111111111
