111111111111111111111111111111111111111111111111
10000000C00000000000000000C000000000001000000001
100000000000000011110001111C00000000001000000001
1E0000000000000C01111111000C00000000001000000001
1111000C0011000000110000C00111100000001000000001
11C00000C1100010010000000000C0000000001000000001
1111111111100000001000000000C0000000001000000001
1CC111100000011011000000000000000000001000000001
1001111000000000011000000000C0000000001000000001
10011000CC011000010000000000C0000000001000000001
1001111000011000001000000000C0000000001000000001
1001111111110000010000000000C0000000001000000001
10C1100000000000011000000000C0000000001000000001
100000000000000P11110000000000C00000001000000001
111111111111111111110000000000C00000001000000001
111111111111111111110000000000000000001000000001
110000C0C0C0C00CC00C0000000000C00000001000000001
111111111111111111111111111111111111000000000001
111111111111111111110000000000C00000001000000001
111111111111111111110000000000C00000001000000001
111111111111111111110000000000C00000001000000001
111111111111111111110000000000C00000001000000001
111111111111111111110000000000C00000001000000001
111111111111111111111111111111111111111111111111
